{
    "Section A": {
        "answers": {
            "26": "E",
            "27": "O",
            "28": "F",
            "29": "C",
            "30": "N",
            "31": "I",
            "32": "K",
            "33": "L",
            "34": "A",
            "35": "J",
            "36": "F",
            "37": "L",
            "38": "I",
            "39": "B",
            "40": "K",
            "41": "A",
            "42": "E",
            "43": "H",
            "44": "D",
            "45": "N"
        }
    },
    "Section B": {
        "answers": {
            "36": "K",
            "37": "D",
            "38": "M",
            "39": "G",
            "40": "B",
            "41": "L",
            "42": "H",
            "43": "F",
            "44": "J",
            "45": "C"
        }
    },
    "Section C": {
        "passage1": "",
        "answers": {
            "51": "B",
            "52": "A",
            "53": "D",
            "54": "D",
            "55": "B"
        },
        "passage2": ""
    }
}